neutral_take,style_take,dice,fpfn_ratio,log_ratio,s1,s2,tp,fp,fn
0,Sad5,0.7836697800542332,0.8367869020209773,-0.17818583825457085,33828,32552,26010,6542,7818
1,Sad5,0.7602124482952738,0.08242183184178543,-2.49590492762341,49162,32552,31060,1492,18102
2,Sad5,0.6973573755078741,0.054604313740785525,-2.9076423931106135,56791,32552,31152,1400,25639
3,Sad5,0.6967839374555792,0.045169193079160924,-3.097339993562837,57496,32552,31372,1180,26124
4,Sad5,0.6443164721141375,0.045888634630053396,-3.0815378041221155,63823,32552,31048,1504,32775
0,Sad6,0.7964229215422228,3.620474777448071,1.2866051712289268,33828,42659,30458,12201,3370
1,Sad6,0.8704980342187517,0.29292160487115365,-1.2278502659323882,49162,42659,39965,2694,9197
2,Sad6,0.8179185520361991,0.12332506203473946,-2.0929316288441,56791,42659,40671,1988,16120
3,Sad6,0.8218661075333233,0.09192729053185629,-2.3867573347067434,57496,42659,41157,1502,16339
4,Sad6,0.7576867451775887,0.0987522888898352,-2.3151406968382835,63823,42659,40340,2319,23483
0,Sad7,0.7607051616101275,3.8237253394824493,1.3412251671604334,33828,44849,29925,14924,3903
1,Sad7,0.8894491070193914,0.4134366925064599,-0.8832508777959549,49162,44849,41809,3040,7353
2,Sad7,0.8422274695001968,0.14632925870326685,-1.921895999815141,56791,44849,42802,2047,13989
3,Sad7,0.8458449362450535,0.1101182099634112,-2.206200854166664,57496,44849,43284,1565,14212
4,Sad7,0.7855933451118964,0.1023324028953967,-2.279528912331778,63823,44849,42686,2163,21137
0,Sad8,0.7690015668747271,3.623650385604113,1.2874819115634688,33828,44034,29938,14096,3890
1,Sad8,0.8483840508176317,0.4674421019835912,-0.7604797839473513,49162,44034,39533,4501,9629
2,Sad8,0.8231688569303248,0.16582750277904923,-1.796807170791007,56791,44034,41498,2536,15293
3,Sad8,0.8277947404707968,0.12996833193304466,-2.0404644587170204,57496,44034,42023,2011,15473
4,Sad8,0.7707612857765375,0.11088646268589657,-2.1992484598323574,63823,44034,41566,2468,22257
0,Sad9,0.7455414598271741,2.5598015800110234,0.9399297476793917,33828,42318,28385,13933,5443
1,Sad9,0.8555531263664189,0.31757902083956524,-1.1470286070819447,49162,42318,39133,3185,10029
2,Sad9,0.8360491983573641,0.05780873641038995,-2.8506153657569753,56791,42318,41430,888,15361
3,Sad9,0.8362955096479452,0.03686782156228187,-3.30041615277016,57496,42318,41737,581,15759
4,Sad9,0.7816772029658662,0.037333810824119254,-3.287855906505177,63823,42318,41484,834,22339
0,Happy10,0.5742547240603042,319.05128205128204,5.7653518486459845,33828,83444,33672,49772,156
1,Happy10,0.7314148681055156,52.39730134932534,3.9588550890337024,49162,83444,48495,34949,667
2,Happy10,0.8029664491745998,55.50511247443763,4.016475133166444,56791,83444,56302,27142,489
3,Happy10,0.8091954022988506,55.97457627118644,4.024897592490761,57496,83444,57024,26420,472
4,Happy10,0.8395635138897377,10.795806290564153,2.379157752290465,63823,83444,61820,21624,2003
0,Happy11,0.5767747440273038,1709.4137931034484,7.44390577967295,33828,83372,33799,49573,29
1,Happy11,0.7380294867732053,135.15686274509804,4.906436050161326,49162,83372,48907,34465,255
2,Happy11,0.8000114152807802,37.663448275862066,3.628690082390022,56791,83372,56066,27306,725
3,Happy11,0.8085725643865179,48.47889908256881,3.881128632810325,57496,83372,56951,26421,545
4,Happy11,0.8260334929854954,7.453945196434467,2.008743448794255,63823,83372,60794,22578,3029
0,Happy12,0.5622900103123648,2391.3636363636365,7.779619041366537,33828,86416,33806,52610,22
1,Happy12,0.7212527106167668,139.4907063197026,4.93799797767798,49162,86416,48893,37523,269
2,Happy12,0.7889837787259003,100.74747474747475,4.612617135971478,56791,86416,56494,29922,297
3,Happy12,0.7912891211295792,52.82795698924731,3.967040539015392,57496,86416,56938,29478,558
4,Happy12,0.8195208967045841,10.992481203007518,2.39721151208797,63823,86416,61562,24854,2261
0,Happy13,0.571377732587697,454.72972972972974,6.119703241868704,33828,84192,33717,50475,111
1,Happy13,0.7347361159020351,204.6627906976744,5.321363701340462,49162,84192,48990,35202,172
2,Happy13,0.7973018023449636,47.60034013605442,3.862839906927273,56791,84192,56203,27989,588
3,Happy13,0.7989808593529445,30.894736842105264,3.430585840661656,57496,84192,56603,27589,893
4,Happy13,0.8317940749248387,9.996908127208481,2.3022758579066522,63823,84192,61559,22633,2264
0,Happy14,0.5409576509723644,19134.333333333332,9.859239557082153,33828,91228,33825,57403,3
1,Happy14,0.6999074008120236,1315.5625,7.182019609804061,49162,91228,49130,42098,32
2,Happy14,0.7659827454583533,341.96039603960395,5.834694929303356,56791,91228,56690,34538,101
3,Happy14,0.7686049326268793,99.9208211143695,4.604378083501426,57496,91228,57155,34073,341
4,Happy14,0.8128809230511251,35.08582089552239,3.5577970857662202,63823,91228,63019,28209,804
0,Relaxed15,0.683643245022215,50.95945945945946,3.9310304040541872,33828,63404,33236,30168,592
1,Relaxed15,0.8480891210489846,10.966410076976906,2.3948369715933486,49162,63404,47733,15671,1429
2,Relaxed15,0.892233453970631,3.086119873817035,1.1269145975861026,56791,63404,53621,9783,3170
3,Relaxed15,0.887394540942928,2.5333506358681546,0.9295427885488075,57496,63404,53643,9761,3853
4,Relaxed15,0.8766063807210733,0.9480084377714356,-0.05339187616394519,63823,63404,55764,7640,8059
0,Relaxed16,0.6919542395411394,37.073738680465716,3.6129088666891263,33828,61713,33055,28658,773
1,Relaxed16,0.8629177001127396,10.479607250755286,2.3494312021176817,49162,61713,47838,13875,1324
2,Relaxed16,0.8535576858165125,1.7918275418275418,0.5832360721021305,56791,61713,50575,11138,6216
3,Relaxed16,0.8302225503107987,1.5264011983522656,0.42291280679560833,57496,61713,49485,12228,8011
4,Relaxed16,0.8485056079530972,0.8002650511170011,-0.22281229229028768,63823,61713,53259,8454,10564
0,Relaxed17,0.7180419241487944,19.726315789473684,2.9819535711978267,33828,56955,32593,24362,1235
1,Relaxed17,0.8770319552946276,3.965372907153729,1.3775999003879262,49162,56955,46534,10421,2628
2,Relaxed17,0.8628874861533592,1.0212545360290306,0.021031808826305128,56791,56955,49075,7880,7716
3,Relaxed17,0.8492892154721234,0.9391793142214727,-0.0627488550428149,57496,56955,48601,8354,8895
4,Relaxed17,0.8485982546490255,0.45392382921205376,-0.7898258720828963,63823,56955,51246,5709,12577
0,Relaxed18,0.6733897269705849,23.098548510313215,3.139769780502167,33828,62755,32519,30236,1309
1,Relaxed18,0.8291501737895047,5.917872648335745,1.777977034370965,49162,62755,46398,16357,2764
2,Relaxed18,0.8629983437337928,2.1453812175917033,0.7633172604079492,56791,62755,51584,11171,5207
3,Relaxed18,0.8563920466357868,1.8757701915070775,0.6290193438837397,57496,62755,51491,11264,6005
4,Relaxed18,0.8584430153739196,0.887496049720847,-0.11935120866123601,63823,62755,54330,8425,9493
0,Relaxed19,0.6975160256410257,37.30440587449933,3.619111439633924,33828,61020,33079,27941,749
1,Relaxed19,0.8774209943547948,15.390776699029127,2.7337684143505054,49162,61020,48338,12682,824
2,Relaxed19,0.8658953747952228,1.731028522039758,0.5487157532621132,56791,61020,51006,10014,5785
3,Relaxed19,0.8573019676668129,1.5264415894831191,0.4229392681194713,57496,61020,50802,10218,6694
4,Relaxed19,0.8605848946276523,0.7225851148060174,-0.32492005997424134,63823,61020,53719,7301,10104
0,Old20,0.6844021503397695,2.0810984216604647,0.7328958416609418,33828,42253,26035,16218,7793
1,Old20,0.7860635563091396,0.477896168669236,-0.7383617904436868,49162,42253,35929,6324,13233
2,Old20,0.7385202536246517,0.28093777821743,-1.269622063998806,56791,42253,36573,5680,20218
3,Old20,0.7483583795326268,0.24434860202260558,-1.4091593764912382,57496,42253,37324,4929,20172
4,Old20,0.6931068290659527,0.20294139383637572,-1.594838041935728,63823,42253,36761,5492,27062
0,Old21,0.6466430616037877,1.6060030015007505,0.473748484452307,33828,39885,23833,16052,9995
1,Old21,0.7737262344604535,0.3694691769183715,-0.9956879604269127,49162,39885,34449,5436,14713
2,Old21,0.7324672100624767,0.2094458732756605,-1.563289934453709,56791,39885,35406,4479,21385
3,Old21,0.7441287314773929,0.17179270127915727,-1.761466754157744,57496,39885,36232,3653,21264
4,Old21,0.6855016006479732,0.15344626374792233,-1.874404846548286,63823,39885,35546,4339,28277
0,Old22,0.7295023139555028,4.024132383360147,1.3923093307056367,33828,46986,29477,17509,4351
1,Old22,0.860215501102467,0.7213114754098361,-0.32668423025505006,49162,46986,41354,5632,7808
2,Old22,0.8171945614153425,0.3185293299972199,-1.1440407203063905,56791,46986,42403,4583,14388
3,Old22,0.8264964300070825,0.2660101962427544,-1.3242206391954021,57496,46986,43177,3809,14319
4,Old22,0.7630968603633279,0.2184831043445971,-1.5210465930902926,63823,46986,42279,4707,21544
0,Old23,0.7253452255212612,2.5017456359102246,0.9169887425720871,33828,42861,27813,15048,6015
1,Old23,0.8128837355878422,0.46420068027210887,-0.7674383196708603,49162,42861,37402,5459,11760
2,Old23,0.7652430457993818,0.2535633908477119,-1.37214142469569,56791,42861,38129,4732,18662
3,Old23,0.7718445150811603,0.22013215389534263,-1.5135272134532305,57496,42861,38730,4131,18766
4,Old23,0.7126654418656968,0.18777123372597646,-1.672530898988519,63823,42861,38015,4846,25808
0,Old24,0.6514192976392624,0.9087468114868756,-0.09568875882075523,33828,32719,21675,11044,12153
1,Old24,0.7339187357262369,0.13978550876275175,-1.967646111473977,49162,32719,30047,2672,19115
2,Old24,0.6931292593006368,0.06589057043073342,-2.719759936775118,56791,32719,31021,1698,25770
3,Old24,0.7006151970293188,0.04310045185957595,-3.144221797946511,57496,32719,31603,1116,25893
4,Old24,0.6310828447722235,0.06762589928057554,-2.6937642438547336,63823,32719,30463,2256,33360
0,Angry25,0.7271124461277263,58.276595744680854,4.06520056755302,33828,58056,33405,24651,423
1,Angry25,0.8994198735286986,10.411640211640211,2.3429244313720226,49162,58056,48217,9839,945
2,Angry25,0.8812768291727254,1.2045270816491511,0.1860870265470169,56791,58056,50606,7450,6185
3,Angry25,0.8702402381611742,1.0775945683802133,0.07473130562266997,57496,58056,50279,7777,7217
4,Angry25,0.8438697396598266,0.5348443297306017,-0.6257795468929971,63823,58056,51425,6631,12398
0,Angry26,0.7209791210363539,22.58232558139535,3.1171675463939827,33828,57029,32753,24276,1075
1,Angry26,0.865647747925907,3.4584375,1.2408168974769673,49162,57029,45962,11067,3200
2,Angry26,0.8402038306097347,1.0265181058495823,0.026172595752452513,56791,57029,47816,9213,8975
3,Angry26,0.8470115695263043,0.9480764954414054,-0.053320088588603126,57496,57029,48502,8527,8994
4,Angry26,0.8004666865256678,0.5603727190371425,-0.5791531469370483,63823,57029,48369,8660,15454
0,Angry27,0.6899631666266682,37.78981723237598,3.6320396809479023,33828,62009,33062,28947,766
1,Angry27,0.8440690467837836,6.725044563279857,1.9058385519759635,49162,62009,46918,15091,2244
2,Angry27,0.8835690235690236,2.211516136521941,0.7936783149407911,56791,62009,52484,9525,4307
3,Angry27,0.8844818208443161,1.9713732242789497,0.6787303680726331,57496,62009,52850,9159,4646
4,Angry27,0.8586369127090089,0.8149168452198755,-0.20466920135179092,63823,62009,54022,7987,9801
0,Angry28,0.7360674382819294,27.795620437956206,3.324878470083131,33828,55854,33006,22848,822
1,Angry28,0.8875790355755313,3.617129448572546,1.2856807412630735,49162,55854,46605,9249,2557
2,Angry28,0.8583248257801056,0.8890861742424242,-0.11756111426003098,56791,55854,48343,7511,8448
3,Angry28,0.8631848257609175,0.8085131195335277,-0.2125583730916503,57496,55854,48921,6933,8575
4,Angry28,0.8150939612456863,0.47046315369792013,-0.7540376360989531,63823,55854,48774,7080,15049
0,Agreement29,0.698143627067115,6.455062571103527,1.8648647176836197,33828,53008,30312,22696,3516
1,Agreement29,0.8526377605950867,1.6861730597680642,0.5224614994887958,49162,53008,43557,9451,5605
2,Agreement29,0.8692975345859252,0.5827726921804346,-0.5399580620038401,56791,53008,47724,5284,9067
3,Agreement29,0.8631904727430681,0.542180965010711,-0.6121554494856778,57496,53008,47693,5315,9803
4,Agreement29,0.8365245525588243,0.27692719128167415,-1.284000654703797,63823,53008,48866,4142,14957
0,Agreement31,0.8275332989431636,4.121366849960722,1.416184868040559,33828,41775,31282,10493,2546
1,Agreement31,0.8170931524022125,0.3849292256452956,-0.9546957910858038,49162,41775,37152,4623,12010
2,Agreement31,0.8178276484791916,0.08916656557078734,-2.417249135100391,56791,41775,40305,1470,16486
3,Agreement31,0.8218714428181443,0.05873548078074482,-2.8347112921478117,57496,41775,40794,981,16702
4,Agreement31,0.770582776188943,0.047067467692440676,-3.0561732237747217,63823,41775,40686,1089,23137
0,Agreement32,0.8645500132698244,2.365845192641444,0.8611353334246231,33828,37763,30947,6816,2881
1,Agreement32,0.8226862237561116,0.1497090854841116,-1.8990612981215649,49162,37763,35756,2007,13406
2,Agreement32,0.7796814518687734,0.04525840441545409,-3.0953668931442166,56791,37763,36861,902,19930
3,Agreement32,0.7686412832383291,0.055204443167672125,-2.896711836770435,57496,37763,36610,1153,20886
4,Agreement32,0.7225208197980036,0.039227252617608024,-3.238383553902143,63823,37763,36699,1064,27124
0,Disagreement30,0.687098249105726,1.8098055790363483,0.5932194246112961,33828,40534,25547,14987,8281
1,Disagreement30,0.8283981448448091,0.2815986677768526,-1.2672723856155037,49162,40534,37152,3382,12010
2,Disagreement30,0.7903621885435397,0.11309328968903437,-2.1795422283979713,56791,40534,38461,2073,18330
3,Disagreement30,0.7847801693359175,0.10867052023121387,-2.2194347246618755,57496,40534,38466,2068,19030
4,Disagreement30,0.7428730224134461,0.0707074737640158,-2.6492040007187287,63823,40534,38762,1772,25061
0,Disagreement33,0.7143872163167501,1.5034802784222738,0.4077826062485269,33828,37951,25639,12312,8189
1,Disagreement33,0.817168505274758,0.1737784656201636,-1.7499739770486367,49162,37951,35593,2358,13569
2,Disagreement33,0.7738700892951383,0.0641764355255315,-2.7461191835537035,56791,37951,36659,1292,20132
3,Disagreement33,0.7765775770846648,0.04355272816246636,-3.133782933272192,57496,37951,37061,890,20435
4,Disagreement33,0.7213237172558806,0.04591215842460449,-3.0810253075677125,63823,37951,36706,1245,27117
0,Disagreement34,0.8709162469380453,3.2929061784897025,1.1917705117917776,33828,38838,31643,7195,2185
1,Disagreement34,0.8474090909090909,0.13068373189626137,-2.0349751351404866,49162,38838,37286,1552,11876
2,Disagreement34,0.7906388229511968,0.05445831358297783,-2.9103197583750404,56791,38838,37804,1034,18987
3,Disagreement34,0.7808250461934519,0.0617519863220356,-2.784629136832931,57496,38838,37610,1228,19886
4,Disagreement34,0.7318455888799057,0.04844422439730357,-3.0273421552371333,63823,38838,37566,1272,26257
0,Flirty35,0.720940408472191,6.0501942037645655,1.8000903713233587,33828,50731,30481,20250,3347
1,Flirty35,0.8699508474067252,1.2747329714585887,0.24273672252586873,49162,50731,43451,7280,5711
2,Flirty35,0.8162050557095292,0.5306327937417706,-0.6336850341718194,56791,50731,43880,6851,12911
3,Flirty35,0.82774169107524,0.4674905541561713,-0.7603761354710568,57496,50731,44792,5939,12704
4,Flirty35,0.7743771496412173,0.32754635574503055,-1.1161256896636387,63823,50731,44354,6377,19469
0,Flirty36,0.702398957295855,3.5960881124192934,1.2798466192066502,33828,47499,28562,18937,5266
1,Flirty36,0.831441843142529,0.8147694364000891,-0.2048501058876527,49162,47499,40184,7315,8978
2,Flirty36,0.7820308754434749,0.4196852360729453,-0.868250286595269,56791,47499,40779,6720,16012
3,Flirty36,0.7811610076670318,0.3936434766785953,-0.9323096608630428,57496,47499,41009,6490,16487
4,Flirty36,0.72923591024236,0.2973787285326906,-1.212748772286493,63823,47499,40590,6909,23233
0,Flirty37,0.6725418154723671,2.331155253528489,0.8463639616660091,33828,44014,26176,17838,7652
1,Flirty37,0.8097578775650383,0.5498819620529859,-0.5980516382377135,49162,44014,37725,6289,11437
2,Flirty37,0.7686523485938197,0.2920937448058064,-1.2306804843819052,56791,44014,38742,5272,18049
3,Flirty37,0.7712934686237809,0.26524606245571963,-1.3270973462514994,57496,44014,39147,4867,18349
4,Flirty37,0.7132987750030139,0.21898040452627843,-1.5187730302179032,63823,44014,38460,5554,25363
0,Pensive38,0.7391561936695618,3.589265912619206,1.2779477004264972,33828,45503,29319,16184,4509
1,Pensive38,0.8660222891248085,0.5521967935381227,-0.5938507862068125,49162,45503,40991,4512,8171
2,Pensive38,0.8339101022542866,0.20164085154537095,-1.6012671266791685,56791,45503,42652,2851,14139
3,Pensive38,0.8147069389023195,0.2282000128708411,-1.477532785152581,57496,45503,41957,3546,15539
4,Pensive38,0.7844245650622907,0.1252864782276547,-2.0771523380857015,63823,45503,42879,2624,20944
0,Pensive39,0.7399816712488545,6.970448741335279,1.9416796045271678,33828,50193,31087,19106,2741
1,Pensive39,0.870917417341855,1.174834661692386,0.16112742424176693,49162,50193,43265,6928,5897
2,Pensive39,0.8467247438869364,0.42616107149069404,-0.8529379020845183,56791,50193,45293,4900,11498
3,Pensive39,0.8435587664478266,0.39519668737060043,-0.9283716953029667,57496,50193,45421,4772,12075
4,Pensive39,0.8010103845074376,0.2494080070488463,-1.388665141003583,63823,50193,45664,4529,18159
0,Pensive40,0.7005649717514124,4.003646677471637,1.3872056151696843,33828,48654,28892,19762,4936
1,Pensive40,0.8288623538071481,0.9410946196660482,-0.06071159220307303,49162,48654,40538,8116,8624
2,Pensive40,0.8146996064298924,0.41198150021679436,-0.8867768330271745,56791,48654,42953,5701,13838
3,Pensive40,0.8243994347621291,0.3565242704315552,-1.0313529616931996,57496,48654,43755,4899,13741
4,Pensive40,0.7678725428309788,0.2650322205533214,-1.3279038733933486,63823,48654,43184,5470,20639
0,Scared41,0.5975889429857373,2.4671386306001692,0.9030590299692752,33828,47713,24364,23349,9464
1,Scared41,0.7442993548387097,0.8894736842105263,-0.11712535723741269,49162,47713,36052,11661,13110
2,Scared41,0.7091211819643267,0.540074982267707,-0.6160472930121169,56791,47713,37053,10660,19738
3,Scared41,0.7218583961448165,0.49889873482559033,-0.6953521400462215,57496,47713,37973,9740,19523
4,Scared41,0.6662422894850093,0.39590520473976304,-0.9265804783543891,63823,47713,37155,10558,26668
0,Scared42,0.672904758176076,2.11470113085622,0.7489134932253039,33828,42798,25781,17017,8047
1,Scared42,0.8161374510656807,0.45307665864558266,-0.7916939434327491,49162,42798,37526,5272,11636
2,Scared42,0.7833596079888341,0.21316914080071975,-1.5456693401276977,56791,42798,39007,3791,17784
3,Scared42,0.7842144096356711,0.1910842047330765,-1.6550410856099762,57496,42798,39326,3472,18170
4,Scared42,0.7285056414777576,0.15852877611462418,-1.841819149369858,63823,42798,38837,3961,24986
0,Scared43,0.6701137782384397,4.2049804868983465,1.4362696529619081,33828,51074,28447,22627,5381
1,Scared43,0.7956023783870066,1.205857019810508,0.1871905339054584,49162,51074,39874,11200,9288
2,Scared43,0.7783432994947388,0.6140552217646662,-0.48767041715168014,56791,51074,41978,9096,14813
3,Scared43,0.7845629547757207,0.5691667784784651,-0.563581779757066,57496,51074,42590,8484,14906
4,Scared43,0.72576307475391,0.4238781689186136,-0.8583092024955957,63823,51074,41694,9380,22129
0,Distracted44,0.733713043155957,4.212333736396614,1.438016825794893,33828,47111,29693,17418,4135
1,Distracted44,0.8670551452639889,0.7237710437710437,-0.32328017449546387,49162,47111,41737,5374,7425
2,Distracted44,0.8173856133664414,0.32435262092552525,-1.1259240188083939,56791,47111,42464,4647,14327
3,Distracted44,0.8112267821465102,0.31069958847736623,-1.1689287870855696,57496,47111,42430,4681,15066
4,Distracted44,0.7548812807615339,0.23870262390670555,-1.432536753210524,63823,47111,41871,5240,21952
0,Distracted45,0.7547933326910107,7.170144462279294,1.9699258025646655,33828,49204,31336,17868,2492
1,Distracted45,0.8908159323343432,1.0078519349411106,0.007821268920418727,49162,49204,43813,5391,5349
2,Distracted45,0.8520401905750271,0.3479157713794585,-1.0557948647690907,56791,49204,45156,4048,11635
3,Distracted45,0.8465042174320525,0.32776651803810297,-1.115453759322686,57496,49204,45161,4043,12335
4,Distracted45,0.7939695824891397,0.228670922809054,-1.4754713272299957,63823,49204,44870,4334,18953
0,Distracted46,0.6813599667321508,1.206653426017875,0.18785076419600386,33828,35909,23758,12151,10070
1,Distracted46,0.8050922170892548,0.11155057987531004,-2.1932771597727765,49162,35909,34245,1664,14917
2,Distracted46,0.7405609492988133,0.0705065432208671,-2.6520497618271435,56791,35909,34325,1584,22466
3,Distracted46,0.7255500240886462,0.08572275634238279,-2.4566369537096073,57496,35909,33885,2024,23611
4,Distracted46,0.6848754662495488,0.05921606956287284,-2.826562328607994,63823,35909,34152,1757,29671
0,Sarcastic47,0.7687891111922539,4.566232191573204,1.5186883991084068,33828,45593,30529,15064,3299
1,Sarcastic47,0.8895572792992454,0.49137808180133963,-0.710541423468705,49162,45593,42145,3448,7017
2,Sarcastic47,0.8312822315986873,0.2134026411913459,-1.544574563474365,56791,45593,42555,3038,14236
3,Sarcastic47,0.8115511839284502,0.24015320778806257,-1.4264781935253164,57496,45593,41831,3762,15665
4,Sarcastic47,0.7725195583826863,0.15445269016697588,-1.867867442048444,63823,45593,42263,3330,21560
0,Sarcastic48,0.7546020331370277,8.158716005349978,2.0990868043093043,33828,49885,31585,18300,2243
1,Sarcastic48,0.8748170060678264,1.1238437821171634,0.11675475793081747,49162,49885,43324,6561,5838
2,Sarcastic48,0.8488319772019949,0.4003126085446336,-0.9155095157413722,56791,49885,45275,4610,11516
3,Sarcastic48,0.836274573714158,0.3957605589075897,-0.9269458998249765,57496,49885,44900,4985,12596
4,Sarcastic48,0.7993808702993633,0.24146938775510204,-1.4210125727021279,63823,49885,45448,4437,18375
0,Sarcastic49,0.7595988368642811,10.080415754923413,2.3105945073207654,33828,50427,32000,18427,1828
1,Sarcastic49,0.8981514022633021,1.2849740932642486,0.25073855726009653,49162,50427,44723,5704,4439
2,Sarcastic49,0.8527299520602883,0.4254762119707502,-0.854546238593202,56791,50427,45714,4713,11077
3,Sarcastic49,0.8404325306005207,0.41794977356937013,-0.8723940126019946,57496,50427,45351,5076,12145
4,Sarcastic49,0.8001575492341356,0.26046152147510215,-1.3453001389672734,63823,50427,45709,4718,18114
0,Threatening50,0.659379641512971,1.15421796625627,0.14342302915544652,33828,35519,22863,12656,10965
1,Threatening50,0.7931413185956708,0.12432605905006419,-2.084847656017743,49162,35519,33582,1937,15580
2,Threatening50,0.7366915827104322,0.06656720347536092,-2.709543263034239,56791,35519,34002,1517,22789
3,Threatening50,0.7232381873891308,0.078918692372171,-2.5393371669947546,57496,35519,33636,1883,23860
4,Threatening50,0.6789877393247569,0.05957404392464365,-2.820535304390585,63823,35519,33726,1793,30097
0,Threatening51,0.6999988293550917,5.52086513994911,1.708534576260065,33828,51595,29898,21697,3930
1,Threatening51,0.8489137231160118,1.380453479280688,0.3224120533636839,49162,51595,42767,8828,6395
2,Threatening51,0.8661819792224088,0.47248730964467006,-0.7497443903038975,56791,51595,46941,4654,9850
3,Threatening51,0.8454226288144759,0.48154981549815495,-0.7307455941169528,57496,51595,46114,5481,11382
4,Threatening51,0.84972881179712,0.17300148789395375,-1.7544550839782573,63823,51595,49037,2558,14786
0,Threatening52,0.7429201567302504,9.126617375231053,2.2111951303628956,33828,51414,31664,19750,2164
1,Threatening52,0.8858375755647471,1.4879739978331528,0.3974154616837239,49162,51414,44547,6867,4615
2,Threatening52,0.8775380065616192,0.42269701524586645,-0.861099632598585,56791,51414,47477,3937,9314
3,Threatening52,0.8646956202368928,0.4156979536939187,-0.8777963552905836,57496,51414,47087,4327,10409
4,Threatening52,0.8404071608945044,0.1942207792207792,-1.6387597297717726,63823,51414,48423,2991,15400
0,Still53,0.2669815185176261,0.07540299773755656,-2.5849082469660196,33828,7673,5540,2133,28288
1,Still53,0.2689188000351896,0.0007466281310211946,-7.199943313354624,49162,7673,7642,31,41520
2,Still53,0.2379932985852569,4.0716612377850165e-05,-10.108874382261078,56791,7673,7671,2,49120
3,Still53,0.23483558133468366,0.0004213145012438809,-7.772130969339335,57496,7673,7652,21,49844
4,Still53,0.21399798590130917,0.00040944937959517917,-7.80069727746432,63823,7673,7650,23,56173
0,Still54,0.25988171722758796,0.255050505050505,-1.3662936944132211,33828,13178,6108,7070,27720
1,Still54,0.4219762592236124,0.0006942708767252631,-7.2726483613252535,49162,13178,13153,25,36009
2,Still54,0.3764524289328131,0.00018339790467893904,-8.603852423076646,56791,13178,13170,8,43621
3,Still54,0.3725839771344483,0.0002706970448905933,-8.2145102779511,57496,13178,13166,12,44330
4,Still54,0.3418397163673199,0.00033555722237574515,-7.9997180575989795,63823,13178,13161,17,50662
0,Still55,0.2675888584742044,0.27806745670009114,-1.279891544725922,33828,14029,6403,7626,27425
1,Still55,0.44398727666914595,2.8462458017874424e-05,-10.466924601573329,49162,14029,14028,1,35134
2,Still55,0.3960180739903982,0.00014029180695847364,-8.871785969150645,56791,14029,14023,6,42768
3,Still55,0.39203075847605734,0.0002070107645597571,-8.482739763346858,57496,14029,14020,9,43476
4,Still55,0.35988799260134613,0.0004014935560284257,-7.8203190744486575,63823,14029,14009,20,49814
0,Laughing56,0.5906548850735418,1.3044470680834317,0.26577924836927946,33828,37696,21123,16573,12705
1,Laughing56,0.745584747518939,0.31676796567751164,-1.1495857425968787,49162,37696,32380,5316,16782
2,Laughing56,0.7091557568766074,0.1800498110614909,-1.7145217382546964,56791,37696,33503,4193,23288
3,Laughing56,0.712559878981427,0.16034095246172766,-1.8304527781222353,57496,37696,33915,3781,23581
4,Laughing56,0.6508732355519656,0.15130745492934872,-1.8884413869010241,63823,37696,33038,4658,30785
0,Laughing57,0.6275534249895641,1.6276838305149155,0.48715804141924834,33828,40435,23302,17133,10526
1,Laughing57,0.7732848198042345,0.39896694214876033,-0.9188767172821629,49162,40435,34642,5793,14520
2,Laughing57,0.7413037664822167,0.21191095692396647,-1.5515891070505172,56791,40435,36037,4398,20754
3,Laughing57,0.759432661772064,0.15997045790251108,-1.8327661189053301,57496,40435,37186,3249,20310
4,Laughing57,0.6940858255481593,0.15386563438370537,-1.8716755614235845,63823,40435,36182,4253,27641
0,Sneaky58,0.7209842254865797,41.86333333333334,3.7344103443619256,33828,58346,33228,25118,600
1,Sneaky58,0.8902407262715333,8.021406727828746,2.0821138089696203,49162,58346,47854,10492,1308
2,Sneaky58,0.8978694946020828,1.3047824382595061,0.26603631289894697,56791,58346,51689,6657,5102
3,Sneaky58,0.9072875123012379,1.1718907987866531,0.15861851171703956,57496,58346,52551,5795,4945
4,Sneaky58,0.8554543296580965,0.5265387275242047,-0.6414303935620612,63823,58346,52255,6091,11568
0,Sneaky59,0.7024562864279766,347.6341463414634,5.8511506231507235,33828,62252,33746,28506,82
1,Sneaky59,0.8725474356903082,24.585585585585587,3.2021603193960044,49162,62252,48607,13645,555
2,Sneaky59,0.8596557546432801,1.971189756357816,0.6786372976906673,56791,62252,51168,11084,5623
3,Sneaky59,0.8710959681998864,1.8906367041198502,0.6369136528267538,57496,62252,52156,10096,5340
4,Sneaky59,0.8316795558199485,0.8621446121446121,-0.14833225888033694,63823,62252,52427,9825,11396
0,Sneaky60,0.7067446121629876,17.829131652661065,2.8808337292118678,33828,57860,32400,25460,1428
1,Sneaky60,0.8623086841957728,3.8810864524677045,1.3561151279613168,49162,57860,46143,11717,3019
2,Sneaky60,0.8666649222422831,1.150372766915178,0.14008603499510455,56791,57860,49682,8178,7109
3,Sneaky60,0.8755851451159887,1.0520446096654275,0.05073551804139847,57496,57860,50502,7358,6994
4,Sneaky60,0.8275108273135935,0.5575096467794598,-0.5842754721572828,63823,57860,50347,7513,13476
0,Tired61,0.6104164859539771,2.418025657751685,0.882951363282575,33828,46871,24630,22241,9198
1,Tired61,0.7497422760925931,0.8259383072481385,-0.1912351968120641,49162,46871,36000,10871,13162
2,Tired61,0.7168682834597055,0.49477973007384773,-0.7036426052005695,56791,46871,37156,9715,19635
3,Tired61,0.7302308200868091,0.4520371325425477,-0.7939909508813626,57496,46871,38106,8765,19390
4,Tired61,0.6739841364482266,0.3607843137254902,-1.0194749681093858,63823,46871,37303,9568,26520
0,Tired62,0.6267824174097498,1.8808368708308065,0.6317168218535734,33828,42543,23934,18609,9894
1,Tired62,0.7677662068589499,0.5257916606963748,-0.6428502270320341,49162,42543,35204,7339,13958
2,Tired62,0.7272837095053053,0.3106584740432532,-1.1690611244177875,56791,42543,36122,6421,20669
3,Tired62,0.7414308419716311,0.2673689367956884,-1.3191257886176584,57496,42543,37086,5457,20410
4,Tired62,0.677227685538612,0.23469754729195139,-1.4494576265762227,63823,42543,36017,6526,27806
0,Tired63,0.6813916419985379,3.9231481481481483,1.366894430508294,33828,49613,28428,21185,5400
1,Tired63,0.8089293849658314,1.0489631961784822,0.04780224412611637,49162,49613,39951,9662,9211
2,Tired63,0.7857975264087816,0.5209876543209877,-0.6520289336304725,56791,49613,41806,7807,14985
3,Tired63,0.7984949910838491,0.4649426457612163,-0.7658412234510833,57496,49613,42763,6850,14733
4,Tired63,0.735516061920378,0.357188093730209,-1.0294927627575832,63823,49613,41717,7896,22106
0,Speech64,0.562672598132448,4.3229139419304214,1.4639296984622308,33828,59235,26182,33053,7646
1,Speech64,0.7384521711855494,2.10219936535726,0.7429841135125134,49162,59235,40023,19212,9139
2,Speech64,0.803664695844035,1.2403619197482298,0.21540320779566155,56791,59235,46623,12612,10168
3,Speech64,0.8240313198721848,1.184980321242421,0.16972616790272416,57496,59235,48095,11140,9401
4,Speech64,0.7977701571616636,0.688674764198955,-0.37298615976444477,63823,59235,49086,10149,14737
0,Speech65,0.6760351879867765,6.887858117326057,1.9297601683833783,33828,55407,30163,25244,3665
1,Speech65,0.7889336227753924,1.7892076330089726,0.5817728587249412,49162,55407,41249,14158,7913
2,Speech65,0.8026702793276173,0.8823329365754123,-0.12518581509221635,56791,55407,45029,10378,11762
3,Speech65,0.8140084851598275,0.819040194040194,-0.19962211936114896,57496,55407,45952,9455,11544
4,Speech65,0.7748888702507758,0.5225777172679827,-0.6489815650213018,63823,55407,46195,9212,17628
0,Speech66,0.6273916614909943,13.801432550736171,2.624772394799839,33828,65998,31315,34683,2513
1,Speech66,0.7774574505036471,4.829845313921747,1.5748144410484768,49162,65998,44766,21232,4396
2,Speech66,0.8555000855125459,3.1572164948453607,1.1496907833555539,56791,65998,52523,13475,4268
3,Speech66,0.8558958329959351,2.829567462879277,1.0401238600019407,57496,65998,52849,13149,4647
4,Speech66,0.8837553246393111,1.336791576339424,0.29027239691730217,63823,65998,57365,8633,6458

style,dice,dice_std,fpfn_ratio,fpfn_ratio_std,log_ratio,log_ratio_std,s1,s1_std,s2,s2_std,tp,tp_std,fp,fp_std,fn,fn_std
Sad,0.7945911756582655,0.03947943005106415,0.695815182290899,0.26674508301460165,-1.584073657394975,0.48019742973963975,52220.0,0.0,41282.4,4460.4779385173515,37218.64,3594.7806328620372,4063.7599999999998,929.1857889571924,15001.36,3594.780632862038
Happy,0.7405070966601892,0.012528554066254248,1072.0824263751551,1564.8345228172645,4.711321017189502,0.78399473162733,52220.0,0.0,85730.4,2961.4186870484896,51536.56,226.8457237860135,34193.840000000004,2742.0093490723175,683.4399999999999,226.84572378601277
Relaxed,0.8268026369898859,0.008518608860258764,9.474861639993069,3.077935590593085,1.2717186848085784,0.3160171668912823,52220.0,0.0,61169.4,2262.147351522442,47180.96,1024.956033398506,13988.439999999999,1451.1155840938375,5039.04,1024.9560333985062
Old,0.7371028388916387,0.03948473201065345,0.6479363282781762,0.283882091598553,-1.1181439703036669,0.5333088669579448,52220.0,0.0,40940.8,4704.597513071655,34467.04,3532.3156674340426,6473.76,1399.3859076037604,17752.96,3532.3156674340416
Angry,0.8308599069725545,0.010510724533136324,9.158720633674186,3.347424617520957,1.0063433695390276,0.284151479139113,52220.0,0.0,58237.0,2312.936337212938,46115.95,1279.6166799084776,12121.05,1304.9297481090691,6104.05,1279.6166799084795
Agreement,0.8088521372208478,0.013289490678891798,1.1266417631547128,0.5776292733240853,-1.2109213847735205,0.8720643214067917,52220.0,0.0,44182.0,6452.273139496395,39016.26666666667,3439.8475715583045,5165.733333333333,3028.2716273295055,13203.733333333335,3439.8475715583036
Disagreement,0.7772315783561546,0.019317192492664684,0.520201335422719,0.14673552249104516,-1.8393898922513543,0.21707826082252693,52220.0,0.0,39107.666666666664,1071.606996783595,35463.666666666664,850.5510422987902,3644.0,980.0319314525759,16756.333333333332,850.5510422987887
Flirty,0.7714018687569449,0.022764112780233152,1.1886346197559343,0.4120331735179319,-0.41559403395374045,0.27512444650890977,52220.0,0.0,47414.666666666664,2742.852084155388,38555.46666666667,2193.198269397659,8859.199999999999,633.5613835033404,13664.533333333333,2193.1982693976597
Pensive,0.8051207988018492,0.01365410133346458,1.326061233738557,0.3803588472017467,-0.49723751269780075,0.2893114517981862,52220.0,0.0,48116.666666666664,1952.0195240371502,40523.333333333336,1154.1262476677132,7593.333333333333,1205.4248748424307,11696.666666666666,1154.1262476677132
Scared,0.7319078346274956,0.031274224483101465,0.9959992549109717,0.31852062553410876,-0.4548971651021878,0.40875115372397175,52220.0,0.0,47195.0,3398.4591606589397,36510.46666666667,1818.9836380670254,10684.533333333333,2847.252759337596,15709.533333333333,1818.983638067026
Distracted,0.7839882495782947,0.04188050668445176,1.0950572398629055,0.618162294426755,-0.9481534151575509,0.7394036920614309,52220.0,0.0,44074.666666666664,5836.879664874223,37926.4,4256.035516769097,6148.266666666666,1640.736138309739,14293.6,4256.035516769098
Sarcastic,0.8225784063896148,0.00631893682342391,1.896999900693218,0.5679316849855024,-0.37262046500122575,0.30967142548325854,52220.0,0.0,48635.0,2162.3696877885304,41556.799999999996,1220.8106268650636,7078.2,954.6797997234469,10663.199999999999,1220.8106268650622
Threatening,0.7942055307884056,0.054313637616088185,1.4106112212379902,0.8412390305385076,-0.7989255950447705,0.8515617762171015,52220.0,0.0,46176.0,7535.9992480537485,39450.93333333333,5590.232158168587,6725.066666666666,2005.2616742515731,12769.066666666668,5590.232158168587
Still,0.3236649495647333,0.056392840408141125,0.04082668331644173,0.018068456333816582,-7.056349197133066,0.28409129577033215,52220.0,0.0,11626.666666666666,2817.1688309759184,10493.066666666666,2326.594858490742,1133.6000000000001,490.94597122969316,41726.93333333333,2326.5948584907414
Laughing,0.7004489002598719,0.018683199459375854,0.4665311074087369,0.04394845696603483,-1.2004971860747902,0.06294729342632088,52220.0,0.0,39065.5,1369.5,32130.800000000003,1339.0000000000018,6934.7,30.5,20089.2,1339.0
Sneaky,0.8365390320087704,0.012606962207850712,30.286786676926173,31.976193261480738,1.3109182104414459,0.5379079470859404,52220.0,0.0,59486.0,1965.8952159258133,46983.666666666664,827.6328708363923,12502.333333333334,1584.9013120345662,5236.333333333333,827.6328708363925
Tired,0.7221241646468625,0.028626525109330427,0.9390765579425885,0.2535941678332751,-0.4537891031810444,0.2462238230670753,52220.0,0.0,46342.333333333336,2910.4228024273193,35748.200000000004,2286.29183322398,10594.133333333333,1373.7099289474795,16471.8,2286.29183322398
Speech,0.7722085161892469,0.022332879028873907,3.093000020627859,1.4876509463890404,0.69576496211103,0.4560737682093321,52220.0,0.0,60213.333333333336,4378.749618580882,43827.666666666664,2785.5425340297506,16385.666666666668,1949.8702201827584,8392.333333333334,2785.542534029752

Normalized
Sad,0.00047325084543855595,5.8353325423636275e-05,0.00040761340346291816,0.00014585819762479713,-0.0009599659327537799,0.00035520214603205515,31.121457047104126,3.5947936416779442,24.560084118815645,3.6850883093892324,22.151269720706107,3.2148849761247766,2.4088143981095373,0.569389104344615,8.970187326398015,2.4264547321700327
Happy,0.0005166774300889968,6.287133103263193e-05,0.6757848127043444,0.9387311035324225,0.0032493930496917955,0.00039858116432284636,36.39796847251497,4.07743149244773,59.621649475062306,5.717510138881725,35.909650753137655,3.920654739732458,23.71199872192464,2.12176924920168,0.4883177193773009,0.1891580922624257
Relaxed,0.0005321000363728261,2.039790167414213e-05,0.006035076184863932,0.0018228696662728006,0.0008124480361146921,0.0001859500772672732,33.607172666531,1.250684532182967,39.33521393961223,1.3600490978621096,30.350528186887125,0.9270497717185642,8.98468575272511,0.8498632737585771,3.2566444796438767,0.7456833641041711
Old,0.00045273171071660395,3.087092447021701e-05,0.00038668002416478425,0.00014127443748836505,-0.0007069399768141274,0.0003706781294304838,32.19471826801576,3.097239366573758,25.060705463452503,2.326626419049145,21.102480315754246,1.621808849543816,3.95822514769826,0.824944243411155,11.092237952261517,2.9525960622369283
Angry,0.0005839089581962977,3.9735927331512006e-05,0.006345309965670772,0.0020521716248878387,0.000707792220841232,0.00020937053013665884,36.72855301350728,2.866352110152604,41.01031619649787,4.114080839745937,32.431092511174576,2.6326314640302932,8.579223685323292,1.484945743576925,4.297460502332698,1.0201492130196939
Agreement,0.0006550769216490156,8.818733576859167e-05,0.0008594572470475833,0.0003291193645192843,-0.0010674285091445493,0.0007582878005319362,42.34887167503205,5.995744320404671,35.209419255934996,2.9057191930338533,31.32489089387968,2.9700294762760366,3.8845283620553155,1.7161775883944874,11.023980781152376,3.827214655658568
Disagreement,0.0006116912245780584,5.7521727373553126e-05,0.0004117141815724326,0.00013425591859517013,-0.0014590499008694947,0.00027269381192243473,41.060112487019644,3.285030229551911,30.688699560507654,1.7774410759756158,27.879708804646935,2.290695237568063,2.8089907558607154,0.5574885677984055,13.180403682372711,1.308246227167872
Flirty,0.0006543707988594422,5.093918355243693e-05,0.001012087878803116,0.0003519113167775653,-0.0003463540519115294,0.00021414665011070287,44.28677574961375,3.105382100634597,40.26465519443877,4.0948673333284225,32.72452187405332,3.141884504390976,7.540133320385441,0.9712292470938547,11.562253875560423,1.822042790721001
Pensive,0.0005440923890982995,4.4173153153997424e-05,0.0008928781846370298,0.0002389108532842191,-0.0003301679449233802,0.00017478465430012784,35.34208894283602,3.4326495558544434,32.59749451451254,3.7002061202437044,27.399483267158868,2.4621895966473297,5.198011247353674,1.2452110516731543,7.942605675677161,1.2694516886950995
Scared,0.000550512283207484,5.600437987802653e-05,0.0007294394128311844,0.00017883478699070945,-0.00036672912464806237,0.0003464388879485234,39.24994732396117,3.213734311527193,35.263901624679136,0.3143240943263297,27.382634574535583,1.9100725028616556,7.881267050143552,1.7389878706512718,11.867312749425595,1.9776258063862997
Distracted,0.0006202423258361006,4.240762931119489e-05,0.0008412822038410375,0.00043320616367570916,-0.0007712963654544184,0.0006152186563312684,41.416694294577816,3.318791496876595,34.789896925517546,4.3654126176703265,29.937894982538612,3.0554111927122096,4.852001942978931,1.3218611507490792,11.478799312039206,3.8687599030817936
Sarcastic,0.0005351919012172965,6.810422132333635e-05,0.0012048465474367828,0.00032887967144038297,-0.0002622050987625463,0.00024354299325970131,33.99155710130348,4.4558239355980165,31.515963954370775,3.171152507178442,26.977214265327547,3.011086538545462,4.53874968904323,0.39263161801308616,7.014342835975931,1.6347948360328552
Threatening,0.0005703678858688801,5.287843291158563e-05,0.0009848120639131353,0.0005477092283880333,-0.0005906081763879738,0.0006338950503870193,37.59121599450487,3.340986577472849,33.127259257557405,5.7872249410231476,28.289622028199474,4.219122945457511,4.837637229357933,1.5710505689023062,9.301593966305392,4.336140848442938
Still,0.00025350039254766645,4.62762829954248e-05,3.2064718193008906e-05,1.4327794617853911e-05,-0.00551472489095678,0.00017234716158560687,40.829470401820124,0.6150537212998746,9.112386219389586,2.274713799914432,8.222103494893734,1.8850884573272089,0.8902827244958532,0.3896834350751959,32.607366906926394,1.5258662935015443
Laughing,0.0005054932724160961,3.0867132410805262e-06,0.0003362137746085169,2.480430486444753e-05,-0.0008677739132359279,6.328318293290854e-05,37.706319268625464,0.7756261993185305,28.18755257197475,0.40862847470135044,23.180690150813163,0.4896068788898038,5.006862421161582,0.08097840418845559,14.525629117812297,1.265233078208336
Sneaky,0.0005654915572172622,7.161099597537281e-05,0.02239003951044299,0.024483832031911432,0.0009234626027710414,0.00046260689733636776,35.281245876474394,4.321127381108031,40.31197727393877,5.977672971698726,31.810960594875677,4.397020196938366,8.5010166790631,1.8382141587134664,3.470285281598715,0.10319636921551478
Tired,0.00043702368896185575,8.863752301953103e-05,0.0005776395759086766,0.00023326960480623169,-0.0002684258059415883,0.0001527122094568664,31.415407994432815,5.216112121364867,27.96970946765481,5.633764621025906,21.669007348411572,4.764517850967916,6.300702119243234,0.9781536556081806,9.746400646021241,1.2456845939497563
Speech,0.0008185835512639312,0.0001060799595831061,0.0034295739208158684,0.002019987321636257,0.0007858309182075567,0.0005911779522865567,55.22533601437706,5.733509766535347,64.15011694284178,11.432738067460045,46.65343519672945,7.948459472962158,17.496681746112333,3.657926700885857,8.571900817647622,2.247574057628822
